curl -X POST --header 'Content-Type: application/json' --header 'Accept: application/json' -d '{  "maze-width": 15,  "maze-height": 25,  "maze-player-name": "Fluttershy",  "difficulty": 0 }' 'https://ponychallenge.trustpilot.com/pony-challenge/maze'


Resp:
{
  "maze_id": "3781e801-facf-4756-87e7-29582da4ce68"
}


curl -X GET --header 'Accept: application/json' 'https://ponychallenge.trustpilot.com/pony-challenge/maze/3781e801-facf-4756-87e7-29582da4ce68/print'

+---+---+---+---+---+---+---+---+---+---+---+---+---+---+---+
|   |                           |       |           |       |
+   +---+---+   +   +---+---+   +   +   +   +---+   +---+   +
|           |   |   |       |       |   |   |   |       |   |
+---+---+   +   +   +   +   +---+---+   +   +   +---+   +   +
|           |   |       |           |       |       |       |
+   +---+---+   +---+---+---+---+   +---+---+---+   +---+   +
|   |               |               |       |       |       |
+   +   +---+---+---+   +---+---+---+   +   +   +   +   +---+
|   |   |       |       |   |           |       |   |   |   |
+   +---+   +   +   +---+   +   +   +---+---+---+   +   +   +
|   |       |   |   |           |               |   |   |   |
+   +   +---+   +   +---+---+---+---+---+---+   +---+   +   +
|       |   |   |       |           |       |       |       |
+---+---+   +   +---+   +   +---+   +   +   +---+   +---+   +
|       |   |       |           |       |       |   |       |
+   +   +   +---+   +   +---+---+---+---+---+   +   +   +---+
|   |       |       |   |                   |   |   |   |   |
+   +---+   +   +---+---+   +---+---+---+   +   +   +   +   +
|   |       |           |   |                   |   |   |   |
+   +---+---+---+---+   +   +---+---+---+---+---+   +   +   +
|                       |   |           |           |       |
+   +---+---+---+---+---+   +   +---+   +---+   +---+---+   +
|           |               |   |   |       |               |
+---+---+   +   +---+---+---+   +   +---+   +   +---+---+---+
|   |       |                       |       |   |           |
+   +   +---+---+   +---+---+---+   +   +---+   +---+---+   +
|   |   |       |   |       |   |   |   |                   |
+   +   +   +   +---+   +   +   +   +   +---+---+   +---+---+
|       |   |       |   |   |       |           |   |       |
+   +---+   +---+   +   +   +   +---+---+---+   +---+   +   +
|           |   |       |   |   |           |   |       |   |
+---+---+---+   +---+---+   +   +   +---+   +   +   +---+   +
|               |           |   |   | D |   |       |       |
+   +---+   +   +   +---+---+---+   +   +   +---+---+   +   +
|   |       |   |   |               |   |               |   |
+   +   +---+---+   +---+---+   +---+   +---+---+   +---+---+
|   |   |       |       |       |                   |       |
+   +   +   +   +---+   +   +   +---+---+   +---+---+   +   +
|   |       |           | P |   |       |   |           | E |
+   +---+---+---+---+---+   +---+   +   +---+   +---+---+   +
|   |   |           |   |           |           |   |       |
+   +   +   +   +   +   +   +---+---+---+---+   +   +   +---+
|   |       |   |   |           |           |       |       |
+   +---+---+   +   +---+---+   +   +---+   +---+   +---+   +
|       |       |           |   |       |       |   |       |
+---+   +   +---+---+---+   +---+---+   +---+   +   +   +   +
|   |       |           |   |           |   |   |   |   |   |
+   +---+---+   +---+---+   +   +---+---+   +   +---+   +   +
|                               |                       |   |
+---+---+---+---+---+---+---+---+---+---+---+---+---+---+---+

get maze current state -----------------------------------------------------
curl -X GET --header 'Accept: application/json' 'https://ponychallenge.trustpilot.com/pony-challenge/maze/3781e801-facf-4756-87e7-29582da4ce68'

Output: See \src\assets\data\sampleMaze.json
